XXXXXXXXXXXXX
XXXX XX XX XX
XXXX XX XX XX
X    XX XX XX
X          XX
XXXXXXXXXXXXX
